11111111111111111111111111111111
100CCCCC0C0C00000000000000000001
10100111011111010011101111000001
101011E0010010000000001C00000001
11111111111111111111111111110111
11111111111111111111111111110111
10000000000C00000000000000000001
10000000000C00000000000000000001
10100111011111010011101111000001
1C1011C0010010000000001C00000001
10000000000C00000000000000000001
10100111011111010011101111000001
1C1011C0010010000000001C00000001
10000000000C00000000000000000001
10100111011111010011101111000001
1C1011C0010010000000001C00000001
11111111111111111111111111110111
10000000000C00000000000000000001
101P0111011111010011101111000001
11111111111111111111111111111111
