11111111111111111111111111111111
1111111111110C011111111111111111
111111111110C1C01111111111111111
11111111110C111C0111111111111111
1111111110C10C01C011111111111111
111111110C10C1C01C01111111111111
11111110C10C111C01C0111111111111
1111110C10C1C0C1C01C011111111111
111110C10C1C01011C01C01111111111
11110C10C1C011C111C11C0111111111
1110C10C1C011C011C0111C011111111
110C10C1C011C011C011111C01111111
11011C11011C011C01111111C0111111
110C10C1E1C010C0111111111C011111
1110C10C1C01C0111111111111C01111
11110C10C01C011111111111111C0111
111110C111C01111111111111111C011
1111110C1C0111111111111111111C01
11111110C011111111111111111111P1
11111111111111111111111111111111
