11111111111111
10000P00000001
1000C000000001
10000000C00001
100000E0000001
11111111111111
